NSA3	AAACTCTGTCGTGCTGGGGATA
ITS9mun	TGTACACACCGCCCGTCG
NSI1	GATTGAATGGCTTAGTGAGG
ITS1-F	CTTGGTCATTTAGAGGAAGTAA
ITS1-F_KYO1	CTHGGTCATTTAGAGGAASTAA
ITS1-F_KYO2	TAGAGGAAGTAAAAGTCGTAA
ITS5	GGAAGTAAAAGTCGTAACAAGG
ITS1	TCCGTAGGTGAACCTGCGG
ITS2	GCTGCGTTCTTCATCGATGC
58A2R	CTGCGTTCTTCATCGAT
ITS10mun	GCTGCGTTCTTCATCGAT
ITS2_KYO1	CTRYGTTCTTCATCGDT
ITS2_KYO2	TTYRCTRCGTTCTTCATC
ITS3_KYO2	GCATCGATGAAGAACGCAGC
58A1F	GCATCGATGAAGAACGC
58A2F	ATCGATGAAGAACGCAG
ITS3_KYO1	AHCGATGAAGAACRYAG
ITS3_KYO2	GATGAAGAACGYAGYRAA
ITS4	TCCTCCGCTTATTGATATGC
ITS4_KYO1	TCCTCCGCTTWTTGWTWTGC
ITS4_KYO2	RBTTTCTTTTCCTCCGCT
ITS8mun	CTTCACTCGCCGTTACTA
ITS4_KYO3	CTBTTVCCKCTTCACTCG
ITS4-B	CAGGAGACTTGTACACGGTCCAG
NLB4	GGATTCTCACCCTCTATGAC
NLB3	GGATTCTCACCCTCTATGA
NLC2	GAGCTGCATTCCCAAACAACTC
NL6Amun	CAAGTGCTTCCCTTTCAACA
NL6Bmun	CAAGCGTTTCCCTTTCAACA
NS7	GAGGCAATAACAGGTCTGTGATGC
LR3	CCGTGTTTCAAGACGGG